Level 1

Layout:
# . # . # . # . # . #
. . . . . . . . . . .
# . # # # . # # # . #
. . # # # . # # # . .
# . # # # . # # # . #
. . . . . . . . . . .
# . # # # . # # # . #
. . # # # . # # # . .
# . # # # . # # # . #
. . . . . . . . . . .
# . # . # . # . # . #